0000000000000000000000000110000000000000000000000000000000000000000000
0000000000000000000000000110000000000000000111111111111111111111111111
0000000000000000000000000110000000000000000000000000000000000000000000
0000000000000000000000000110000000000000000000000000000000000000000000
0000000000000000000000000110000000000000000110000000000000000000000000
0000000000000000000000000110000000000000000110000000000000000000000000
0000000000000000000000000110000000000000000110000000000000000000000000
0000000000000000000000000110000000000000000110000000000000000000000000
0000000000000000000000000110000000000000000110000000000000000000000000
0000000000000000000000000110000000000000000110000000000000000000000000
0000000000000000000000000110000000000000000110000000000000000000000000
0000000000000000000000000110000000000000000110000000000000000000000000
0000000000000000000000000110000000000000000110000000000000000000000000
0000000000000000000000000110000000000000000110000000000000000000000000
0000000000000000000000000110000000000000000110000000000000000000000000
0000000000000000000000000000000000000000000110000000000000000000000000
0000000000000000000000000000000000000000000110000000000000000000000000
1111111111111111111111111110000000000000000110000000000000000000000000
0000000000000000000000000000000000000000000110000000000000000000000000
0000000000000000000000000000000000000000000110000000000000000000000000