0000000000000000000000000000000000000000000000000000000000000000000000
1111111111000000000000000111111111111111111111111111111111111000000000
0000000000000000000000000000000000000000000000000000000000000000000000
0000000000000000000000000110000000000000000000000000000000000000000000
0000000000000000000000000110000000000000000000000000000000000000000000
0000000000000000000000000110000000000000000000000001100000000000000000
0000000000000000000000000110000000000000000000000001100000000000000000
0000000000000000000000000110000000000000000000000001100000000000000000
0000000000000000000000000110000000000000000000000001100000000000000000
0000000000000000000000000110000000000000000000000001100000000000000000
0000000000000000000000000110000000000000000000000000000000000000000000
0000000000000000000000000110000000000000000000000000000000000000000000
1111111111111111111111111110000000000111111111111111111111111111111111
0000000000000000000000000000000000000000000000000000000000000000000000
0000000000000000000000000000000000000000000000000000000000000000000000
0000000000000000000000000000000000000000000000000000000000000000000000
1111111111111111111111111111111111111111111111111000000001111111111111
0000000000000000000000000000000000000000000000000000000000000000000000
0000000000000000000000000000000000000000000000000000000000000000000000
0000000000000000000000000000000000000000000000000000000000000000000000
