0000000000000000000000000000000000000000000000000000000000000000000000
0000000000000000000000000000000000000000000000000000000000000000000000
0000000000000000000000000000000000000000000000000000000000000000000000
0000000000000000000000000000000000000000000000000000000000000000000000
0000000111111111111000000001111111100110000000000111111111111000000000
0000000000000000011000000001100000000110000000000110000000011000000000
0000000110000000011000000001100000000110000000000110000000000000000000
0000000110000000011000000001100000000110000000000110000000011000000000
0000000110000000011000000000000000000110000000000110000000011000000000
0000000111111110011000000001111111111110000000000110000000011000000000
0000000110000000000000000001111000000000000000000110000000011000000000
0000000110000000000000000001100110000000000000000110000000011000000000
0000000110000000000000000001100001100000000000000110000000011000000000
0000000110000000000000000001100000011000000000000000000000011000000000
0000000110000000000000000001100000000110000000000111111111111000000000
0000000000000000000000000000000000000000000000000000000000000000000000
0000000000000000000000000000000000000000000000000000000000000000000000
0000000000000000000000000000000000000000000000000000000000000000000000
0000000000000000000000000000000000000000000000000000000000000000000000
0000000000000000000000000000000000000000000000000000000000000000000000